..P..X...P.........
...X.....P...X.....
.P......X......P...
......X.......P....
..X.....P..........
.....P..X......X...
....X.......P......
..P...........X....
.......X..P........
....P.....X........
...........X....P..
....X..P...........
..P........X.......
.......P....X......
....X..........P...
..P...........X....
.....X.......P.....
.......V...........
..P...........X....
....P.....X........
